22,22,22,22,22,22,22,22,22,22,22,22,22,22,22,22,22,22,22,22
22,0,0,0,0,0,0,0,0,0,0,0,0,0,0,0,0,0,0,22
22,0,0,0,0,0,0,0,0,0,0,0,0,0,0,0,0,0,0,22
22,0,0,0,0,0,0,0,0,0,0,0,0,0,0,0,0,0,0,22
22,0,0,0,0,0,0,0,0,0,0,0,0,0,0,0,0,0,0,22
22,0,0,0,0,0,0,0,0,0,0,0,0,0,0,0,0,0,0,22
22,1,1,1,1,1,1,1,1,1,1,1,1,1,1,1,1,1,1,22
22,1,1,22,22,22,22,22,22,22,22,22,22,22,22,22,22,22,22,22
22,1,1,1,1,1,1,1,1,1,1,1,1,1,1,1,1,1,1,22
22,22,22,22,22,22,22,22,22,22,22,22,22,22,22,22,1,1,22,22
